type octile
height 60
width 107
map
...@..@.@@.@..@......@...@@..@.@....@.@.....@.@@.@@....@..@...@@...@...@........@..@..@.....@@@...@.@......
........@@.....@.@....@...@....@.@....@.......@..@...@@...@..@@@...@...@.@...@@....@@...@....@@.@..........
@@.......@............@@@.....@..@............@@@....@@@....@@...@...........@.........@............@..@.@.
@.@....@....@.@......@@..@......@@@..@..........@@@.@.....@@@..@...@..@@.@.@...@....@...@@....@..@@@@.@@@@@
@.@...@......@@@.@.@.@@@.......@.........@....@@@........@.@@@..@.@@....@.@@.@...@..@.@...@.@...@@..@....@.
.@@@@..@..@.@......@@.@..@....@...@..@.@..@..@@.@.@...@.......@........@....@.@..@....@.............@..@..@
@.@@............@....@.@@.....@......@.....@..@@@....@.......@...@..@.....@..........@..@..@@............@.
.@@@..@.......@.@......@...@....@@.....@....@....@.@@@.@@.......@.....@@@...@@...........@....@@.....@.@.@@
@......@......@....@.......@@@.@@@..@.....@....@.@......@.@..@.@.@.....@.......@..@@....@...@...@......@.@@
........@.@@.@@......@..@.....@@..@......@...@......@.@...@@.@...@..@@@@@.......@.@......@..@.@@.@....@...@
........@..@....@....@...@...@...@............@.@...@@@.@@......@.@@..@.@...@..@.@@...@...@..@.@@.@.@@....@
.@...@..@..@@...@.@@@@....@@.@..@...@....@.@.......@.@.@@@....@.@@..@@@.@@..@.....@.@.@@@...@..@.@@....@.@.
....@....@..@..@....@@@.@........@@@.@....@...@@...@@......@....@@@.@...............@.........@@..@..@....@
...@@.@..@@@.@..@.........@......@@.....@@@.............@.@@....@...@.........@@..@..@....@@...@@.@..@@@@..
@@@..@.@@..@..........@.@..@..@@....@.@....@@@@@...@.@.@......@...@.@......@..@.........@.@......@.@....@.@
...@.....@@..@..@@@..@@@..........@@.....@@....@.....@.....@...@..@..@@.....@@@....@.........@@.@@.........
@.@@..@..@..@@....@@....@.@@@...@@@@...@....@.@@.@.@..@@@@@.@@..@...@...........@....@@.@@@@@....@....@....
..@@.@..@..........@.....@.@.@..@.@...@.....@@..@.@@@.@...@.@@..@....@@.@....@.@...@..@@.......@........@..
@.@.@....@..@@..@.@.....@@@......@@.@.....@.........@..@@.@.............@....@@..@.@@...@@.................
@.@@..@@...@...@..@@...@..@.@@..@@..@.@....@....@@.....@..@..........@..........@.@............@..@..@..@@@
@........@...@...@@.@@.@....@.@.@.......@@.@@@.....@.....@@.@.........@@@..@............@.@....@@@@@...@.@.
..@..@..........@....@.@.@.@.@....@@.@@....@@..@.@@........@@@.@......@@@..@............@@..........@......
...@.@...@.@..@...@@..@@@.....@.....@@.@..@@.......@@@..@....@..@.@.....@..@....@@..@@......@.@....@.....@.
@........@@@@...@...@....@.@@.@.@@......@..@@@.@@@..@@@...@@...@@@..@.@.@@..@..@@@.@@.....@.@...@@...@..@..
..@....@@@..@......@.@@@....@......@....@.@.@..@........@.........@.......@@@.@@.@@@.@@....@.@@@@..@......@
...@@.....@@..@..@@...@@@.@..@.......@.@.@.......@....@....@..@.......@@.@..@...@@.@.@.@..@@...@.@..@...@..
..........@.@@@@............@.....@@......@@....@.....@@..@....@.@..@@....@@@@..@@...@@@......@@.@....@....
.@...@@.......@......@..@......@.@........@.@..........@.@@..@....@@....@@....@@......@.@...@@.....@.@...@@
@@.@.@@.@@.@....@..@.@........@...@...@.........@.....@...@..@@....@@.@...@..@.@..@.@...@..@@..@@.@@@..@...
.....@...@@...@@.@...@@........@..@...@.....@...@@.@@.@.@.@@.@......@.@@.@..@.@.@.@.@..@..@..@...@...@@....
@............@@@@.@...@@@.....@....@@....@@....@....@...@@.......@.@.....@.......@..@@....@.@....@..@@.....
.@@...@@..@@.@...@..@@.@.....@......@@@.@........@.@..@..@...@.@.@.@..@...@......@..@..@...@@@.........@@.@
@..@@......@.@...@..@.........@@.@......@@......@.@..@..@...@..@.....@..@..@......@@@..@..@@@...@@..@.@@.@.
.@.@....@..@......@...@.@..@@@@......@..@....@@@..@........@@@......@@@@.....@@@...@..@@@@.@.....@..@.@.@.@
@..@..@.....@@@@@......@..@@.@@.@@.....@.....@.....@.@...........@.@@.@...@...@...@@...@...@...@.@@@.....@@
.................@......@..@.@..@@.@@.....@@@@@.......@@..@.@@......@..@.......@@..@@@...@..@..@.@..@......
.@..........@..@.....@.@@......@@.@@@...@....@.@......@.@.........@..@..@@...@.@@..........@.....@.@.....@.
@.@..@......@@............@.@.@@.........@..@..@.@..@......@..@@.@@....@@.@....@.@.@..@.@....@@...@@.@.....
....@...@......@..@.......@..@........@@.@@.@.........@@..@..@...@...@@@@.@.......@......@.@..@@@....@@@...
.@......@...@.@.@...@...@..@..@....@@.@.@....@.@.......@..@.@............@@@@@@..@..@....@@........@..@@...
.....@..@@......@@..@..@..@.@@.@@.....@............@.@..@.............@@....@..@.@......@...@...@.@.@......
@.@@@.........@...@..@.............@@.@...@....@..........@@.@.....@.....@@.@............@..@.@.....@.@....
....@@.......@....@..@....@@......@.....@@.........@.....@.@...@...@...@.@...@@...@@@@...@.@@....@.........
...@.@@@.@@@.@.@......@.......@.@.@.....@..@@...@......@....@...........@.@.@.......@......@........@......
..@....@...@.@..@@@.@...@@..@..@....@.............@@@.@...........@.@@...@....@.@....@.@....@@.@...@..@..@.
.........@@.@..@...@@..@@.@...@...@..@.@.....@@@@@...@.@.@.@.......@@@@......@@.@.@...@.@.@.@....@.........
@..@@..@...@.......@......@......@......@@@.@.@.@.@......@@....@@@..@@....@@..@.@.......@......@@.@......@.
.....@......@....@...@.@@.@..........@...@.@@.@@.@@..@@..@.@..@..@....@@@.@....@..@@..@..@...@@.....@@.....
..@...@@.@@@..@@@.@........@.@..@..@@........@@........@...@.@.@...@....@...@@@..@@.@............@..@..@...
..@.@.@.@@...@.@..@@...@....@@..@...........@..@.@....@..@@@......@@...@@..@.................@....@.....@..
@@..@.@...@.......@@.@.........@.....@.@..@@@.@.@@.......@...@.@.@.@..@.....@..@..@...@...@.@@@@..@@.......
.@@@@@......@..@..@@.........@...@..@..@.@@@..@.@.......@@......@...@...........@@.....@....@.....@......@.
....@.@..@..@.@...@.....@@@@@......@...@...@...@.@@...@@@@.@.@...@@@..@..@..@...............@......@....@..
....@@..@@@@..@....@..@.......@...@...........@.@@@......@....@@..@..@@.@.@@...@@..@........@@@@..@..@.....
..@@.@..@.......@@.@..@...@.@.@.@...@...@.....@.@@....@....@..@@..@.@...@........@...@...@.....@..@...@....
.@....@..@@@...........@@@............@.....@.@....@.@........@..........@..@@@@..............@.........@..
@@@..@..............@@....@@@.....@@@...@....@....@..@...@...@...@....@.@....@..........@@@@.@.@.......@...
@.@...@......@....@..@.@........@@.@@@.@...@@@...@@@.........@.@@.............@....@.@.@......@.@@.........
.@..@...@.....@....@...@.............@..@....@@...@...@..@...@@.@.@..@..@.@@....@@.@......@...@...@..@..@..
.@@@@........@.....@@..@@...@@@@...@.................@.@@@..@...@...................@@@.@@....@@@...@@..@..
